###....G...G..G..G...G....###
###.......................###
###.......................###
###.......................###
###.......................###
###.......................###
###.......................###
###.......................###
###.......................###
###.......................###
###.......................###
###.......................###
###.......................###
###.......................###
###.......................###
###.......................###
###.......................###
###.......................###
###.......................###
###.......................###
###.......................###
###.......................###
###.......................###
###.......................###
###.......................###
###.......................###
###.......................###
###.......................###
###.......................###
###.......................###
###.......................###
###.......................###
###.......................###
###.......................###
###.......................###
###.......................###
###.......................###
###.......................###
###.......................###
###.......................###
###.......................###
###.......................###
###.......................###
###.......................###
###.......................###
###.......................###
###.......................###
###.......................###
###.......................###
###.......................###
###......SSSSSSSSSS.......###
